10
-.-.-.-.-.-.-.-.-.-
-.-.-.P_G.-.-.-.H_P.-.-
-.P.-.-.W.-.-.-.-.-
P.-.-.-.-.-.-.W.-.-
-.-.-.-.-.P_G.-.-.P.-
-.W.-.W.-.-.-.-.-.-
-.-.-.-.-.-.-.P.-.-
-.-.-.-.-.-.-.-.-.-
-.-.-.-.P_G.-.-.-.-.-
-.-.-.-.-.-.-.-.-.G
