10
-.-.-.-.P.-.-.-.-.-
-.-.-.-.-.-.G.-.-.-
-.-.W.-.-.-.-.-.W.-
-.P.-.-.-.-.P_G.-.-.-
-.-.-.-.-.-.-.-.-.-
-.W.-.-.-.-.-.-.-.-
-.-.-.-.P_G.-.-.P.-.-
-.-.-.-.-.-.W.-.-.-
-.-.-.-.-.-.-.-.-.-
-.P_G.-.-.-.-.-.H_P.-.-
