10
-.-.-.-.-.-.-.-.-.-
-.-.-.-.-.-.G.-.-.-
-.P.-.-.-.-.-.-.-.-
-.-.-.-.-.-.-.-.-.-
-.-.-.-.-.-.-.-.-.-
-.W.-.-.-.-.-.-.-.-
-.-.-.-.-.-.-.P.-.-
-.-.-.-.-.-.-.-.-.-
-.-.-.-.-.-.H_P.-.-.-
-.P_G.-.-.-.-.-.-.-.-
