10
-.-.-.-.-.-.-.-.-.P
P_G.-.-.-.-.-.-.-.-.-
-.-.-.-.-.-.-.-.-.-
-.-.-.-.P.-.-.W.-.-
-.-.-.P_G.-.-.-.-.P_G.-
-.-.-.-.G.-.-.-.-.-
P.-.-.-.-.-.-.W.-.-
-.P.-.-.-.G.-.-.-.-
-.-.-.-.-.-.-.H_P.-.-
-.-.-.-.-.-.-.-.-.-